S A A A A A A A A A A A A A A
S A A A A A A A A A A A A A A
S A A A A A A A A A A A A A A
S A A A A A A A A A A A A A A
S A A A A A A A A A A A A A A
S A A A A A A A A A A A A A A
S A A A A A A A A A A A A A A
S A A A A A A A A A A A A A A
S A A A A A A A A A A A A A A
S A A A A A A A A A A A A A A
S A A A A A A A A A A A A A A
S A A A Q A A A A A A A A A A
S A A A A A A A A A A A A A A
S A A A A A A A A A A A A A A
S A A A A A A A A A A A A A A
S S A A S A A A A A A A A A A
S S A A Q P A A A A A A A A A
S A A A S A A A Q A A A A A A
S A A A Q A A A A A A A A A A
S A A A S A A A A A A A A A A
S A A A A A A A A A A A A A A
S A A A A A A A A A A A A A A
S A A A A A A A A A A A A A A
S S S A A A A A A A A A A A A
S S S A A A A A A A A A A A A
S A A A A A A A A A A A A A A
S A A A A A A A A A A A A A A
S A A A A A A A A A A A A A A
S A A A A A A A A A A A A A A
S A A A A A A A A A A A A A A
S A A A A A A A A A A A A A A
S A A A A A A A A A A A A A A
S A A A A A A A A A A A A A A
S S S S A A A A A A A A A A A
S S S S A A A A A A A A A A A
S S A A A A A A A A A A A A A
S S A A A A A A A A A A A A A
S A A A A A A A A A A A A A A
S A A A A A A A A A A A A A A
S A A A A A A A A A A A A A A
S A A A A A A A A A A A A A A
S S S S S A A A A A A A A A A
S S S S S A A A A A A A A A A
S A A A A A A A A A A A A A A
S A A A A A A A A A A A A A A
S A A A A A A A A A A A A A A
S A A A A A A A A A A A A A A
S S A A A A A A A A A A A A A
S S A A A A A A A A A A A A A
S S A A A A A A A A A A A A A
S A A A A A A A A A A A A A A
S A A A A A A A A A A A A A A
S S S S S A A A A A A A A A A
S S S S S A A A A A A A A A A
S A A A A A A A A A A A A A A
S A A A A A A A A A A A A A A
S A A A A A A A A A A A A A A
S A A A A A A A A A A A A A A
S A A A A A A A A A A A A A A
S A A A A S P A A A A A A A A
S A A A A A A A A A A A A A A
S A A A A A A A A A A A A A A
S A A A A A A A A A A A A A A
S A A A A A A A A A A A A A A
A A A A A A A A A A A A A A A
A A A A A A A A A A A A A A A
S A A A A A A A A A A A A A A
S A A A A A A A A A A A A A A
S A A A A A A A A A A A A A A
S A A A A A A A A A A A A A A
S A A A A A A A A A A A A A A
S A A A A A A A A A A A A A A
S A A A S A A A A A A A A A A
S A A A Q P A A A A A A A A A
S A A A S A S S A A A A A A A
S A A A A A A A S A A A A A A
S A A A A A A A S S A A A A A
S A A A A A A A S A A A A A A
S A A A A A A A S A A A A A A
S A A A A A A A S A A A A A A
S A A A A A A A S A A A A A A
A A A A A A A A S A A A A A A
A A A A A A A A S A A A A A A
A A A A A A A A A A A A A A A
S A A A A A A A A A A A A A A
S A A A A A A A A A A A A A A
S A A A A A A A S A A A A A A
S A A A A A A A S A A A A A A
S A A A A A A A S A A A A A A
S A A A S P P A Q A A A A A A
S S A A A A A A A A A A A A A
S S A A A A A A A A A A A A A
S S A A A A A A A A A A A A A
S A A A A A A A A A A A A A A
S A A A A A A A A A A A A A A
S A A A S A A A A A A A A A A
S A A A S P A A A A A A A A A
S A A A A A A A A A A A A A A
S A A A A A A A A A A A A A A
S A A A A A A A A A A A A A A
S S A A A A A A A A A A A A A
S S A A Q A A A A A A A A A A
S A A A A A A A A A A A A A A
S A A A A A A A A A A A A A A
S A A A Q A A A Q P A A A A A
S A A A A A A A A A A A A A A
S A A A A A A A A A A A A A A
S A A A Q A A A A A A A A A A
S A A A A A A A A A A A A A A
S A A A A A A A A A A A A A A
S A A A A A A A A A A A A A A
S A A A A A A A A A A A A A A
S A A A A A A A A A A A A A A
S A A A S A A A A A A A A A A
S A A A A A A A A A A A A A A
S A A A A A A A A A A A A A A
S A A A A A A A S A A A A A A
S A A A A A A A S A A A A A A
S S A A A A A A S A A A A A A
S S A A A A A A A A A A A A A
S S A A A A A A A A A A A A A
S A A A A A A A A A A A A A A
S S A A A A A A A A A A A A A
S S A A A A A A S A A A A A A
S S A A S A A A Q A A A A A A
S A A A S A A A Q A A A A A A
S A A A A A A A S A A A A A A
S A A A A A A A A A A A A A A
S A A A A A A A A A A A A A A
S S A A A A A A A A A A A A A
S S S A A A A A A A A A A A A
S S S S A A A A A A A A A A A
S S S S S A A A A A A A A A A
S A A A A A A A A A A A A A A
S A A A A A A A A A A A A A A
S S S S S A A A A A A A A A A
S S S S A A A A A A A A A A A
S S S A A A A A A A A A A A A
S S A A A A A A A A A A A A A
S A A A A A A A A A A A A A A
S A A A A A A A A A A A A A A
S A A A A A A A A A A A A A A
S A A A A A A A A A A A A A A
S S A A A A A A A A A A A A A
S S S A A A A A A A A A A A A
S S S S A A A A A A A A A A A
S S S S S A A A A A A A A A A
S S S S S A A A A A A A A A A
A A A A A A A A A A A A A A A
A A A A A A A A A A A A A A A
S S S S S A A A A A A A A A A
S S S S A A A A A A A A A A A
S S S A A A A A A A A A A A A
S S A A A A A A A A A A A A A
S A A A A A A A A A A A A A A
S A A A A A A A A A A A A A A
S A A A A A A A A A A A A A A
S A A A A A A A A A A A A A A
S S S A A A A A A A A A A A A
S S S A A A A A A A A A A A A
S A A A A A A A A A A A A A A
S A A A A A A A A A A A A A A
S A A A A A A A A A A A A A A
S A A A S A A A A A A A A A A
S A A A S A A A A A A A A A A
S A A A Q A A A A A A A A A A
S A A A S A A A A A A A A A A
S A A A A A A A A A A A A A A
S S A A A A A A A A A A A A A
S S A A A A A A A A A A A A A
S S A A A A A A A A A A A A A
S A A A A A A A A A A A A A A
S A A A A A A A A A A A A A A
S A A A A A A A A A A A A A A
S S S A A A A A A A A A A A A
S S S A A A A A A A A A A A A
S S A A A A A A A A A A A A A
S S S A A A A A A A A A A A A
S S S S A A A A A A A A A A A
S S S S S A A A A A A A A A A
S S S S S S A A A A A A A A A
S S S S S S S A A A A A A A A
S S S S S S S S A A A A A A A
S S S S S S S S S A A A A A A
S S S S S S S S S A A A A A A
S A A A A A A A A A A A A A A
S A A A A A A A A A A A A A A
S A A A A A A A A A A A A A A
S A A A A A A A A A A A A A A
S A A A A A A A A A A A A A A
S A A A A A A A A A A A A A A
S A A A A A A A A A A A A A A
S A A A A A A A A A A A A A A
S S A A A A A A A A A A A A A
S S S S S S S S S S S S S S S
